....................
....................
.....###.....$$$$...
.......#............
.......#####.....*..
$$$........###......
........*...........
