....................
....................
.....###............
.......#............
.......#####.....*..
...........###......
........*...........

